06 06 06 06 06 06 06 06 06 06 06 06 06 06 06 06 06 06 06 06
06 06 06 06 06 06 06 06 06 06 06 06 06 06 06 06 06 06 06 06
06 06 06 06 06 06 06 06 06 10 10 06 06 06 06 06 06 06 06 06
06 06 06 06 06 06 06 06 07 08 08 05 06 06 06 06 06 06 06 06
06 06 10 10 10 10 06 06 11 08 08 09 06 06 06 06 06 06 06 06
06 07 12 12 12 12 09 11 00 00 00 00 09 10 06 06 06 06 06 06
06 07 12 12 12 12 08 08 00 04 04 00 08 08 05 06 06 06 06 06
06 07 12 12 12 12 08 08 00 04 04 00 08 08 05 06 06 06 06 06
06 07 12 12 12 12 01 03 00 00 00 00 01 02 06 06 06 06 06 06
06 06 02 02 02 02 06 06 03 08 08 01 06 06 06 06 06 06 06 06
06 06 06 06 06 06 06 06 07 08 08 05 06 06 06 06 06 06 06 06
06 06 06 06 06 06 06 06 06 02 02 06 06 06 06 06 06 06 06 06
06 06 06 06 06 06 06 06 06 06 06 06 06 06 06 06 06 06 06 06
06 06 06 06 06 06 06 06 06 06 06 06 06 06 06 06 06 06 06 06
06 06 06 06 06 06 06 06 06 06 06 06 06 06 06 06 06 06 06 06
